11111111111
00000000001
11111011111
10000001111
11111100001
11100001111
11101111111
10001110001
10110000101
10000111101
11111111191
