111111101111111
101000000000001
101111111111101
101000001000101
100011101110001
101010000010101
101110111010101
101000101010101
101010101110101
101010000010101
101011111110111
101000000000101
101111101111101
100100000000001
119111111111111
